1 3 1 1 1 1 1 1 1 1 1 1 1 1 1 1 1 1 1 1 1 1 1 1 1 1 1 1 1 1 1 1 1 1 1 1 1 1 1 1 1
1 5 1 1 1 1 1 5 5 5 1 1 1 1 1 1 1 1 1 1 1 1 1 1 1 1 1 1 1 1 1 1 1 5 5 5 1 5 5 5 1
1 5 1 1 1 1 1 5 1 5 1 1 1 1 1 1 1 1 1 1 1 1 1 1 1 1 1 1 1 1 1 1 1 5 1 5 1 5 1 5 1
1 5 5 5 1 5 5 5 1 5 1 1 1 1 1 1 1 1 1 1 1 1 1 1 1 1 1 1 1 1 1 5 5 5 1 5 5 5 1 5 1
1 1 1 5 1 5 1 1 1 5 1 1 1 1 1 1 1 1 1 1 1 1 1 1 1 1 1 1 1 1 1 5 1 1 1 1 1 1 1 1 1
1 1 1 5 1 5 1 5 5 5 1 5 5 5 1 1 1 1 1 1 1 1 1 1 1 1 1 1 1 1 1 5 1 1 1 5 5 5 5 5 1
1 1 1 5 1 5 1 5 1 1 1 5 1 5 1 1 1 1 1 1 1 1 1 1 1 1 1 1 1 1 1 5 1 1 1 5 1 1 1 5 1
1 5 5 5 1 5 1 5 5 5 5 5 1 5 1 1 1 1 1 1 1 1 1 1 1 1 1 1 1 1 1 5 1 5 5 5 1 1 1 5 1
1 5 1 1 1 5 1 1 1 1 1 1 1 5 1 1 1 1 1 1 1 1 1 1 1 1 1 1 1 1 1 5 1 5 1 1 1 1 1 5 1
1 5 1 1 1 5 5 5 1 5 5 5 5 5 1 1 1 1 1 1 1 1 1 1 1 1 1 1 1 1 1 5 1 5 5 5 1 1 1 5 1
1 5 1 1 1 1 1 5 1 5 1 1 1 1 1 1 1 1 1 1 1 1 1 1 1 1 1 1 1 1 1 5 1 1 1 5 1 1 1 5 1
1 5 5 5 1 1 1 5 1 5 1 5 5 5 1 1 1 1 1 1 1 1 1 1 1 1 1 1 1 1 1 5 5 5 5 5 1 1 1 5 1
1 1 1 5 1 1 1 5 1 5 1 5 1 5 1 1 1 1 1 1 1 1 1 1 1 1 1 1 1 1 1 1 1 1 1 1 1 1 1 5 1
1 5 5 5 1 1 1 5 1 5 1 5 1 5 5 5 1 1 1 1 1 1 1 1 1 1 1 1 1 1 1 5 5 5 1 1 1 5 5 5 1
1 5 1 1 1 1 1 5 1 5 1 5 1 1 1 5 1 1 1 1 1 1 1 1 1 1 1 1 1 1 1 5 1 5 1 1 1 5 1 1 1
1 5 1 1 1 1 1 5 1 5 5 5 1 1 1 5 1 1 1 1 1 1 1 1 1 1 1 5 5 5 5 5 1 5 1 1 1 5 1 1 1
1 5 1 1 1 1 1 5 1 1 1 1 1 1 1 5 1 1 1 1 1 1 1 1 1 1 1 5 1 1 1 1 1 5 1 1 1 5 1 1 1
1 5 1 1 1 1 1 5 5 5 5 5 1 5 5 5 1 1 1 1 1 1 1 1 1 5 5 5 1 1 1 1 1 5 1 1 1 5 5 5 1
1 5 1 1 1 1 1 1 1 1 1 5 1 5 1 1 1 1 1 1 1 1 1 1 1 5 1 1 1 1 1 1 1 5 1 1 1 1 1 5 1
1 5 1 1 1 5 5 5 1 1 1 5 1 5 1 1 1 5 5 5 1 1 1 1 1 5 5 5 1 1 1 1 1 5 1 1 1 1 1 5 1
1 5 1 1 1 5 1 5 1 1 1 5 1 5 1 1 1 5 1 5 1 1 1 1 1 1 1 5 1 1 1 1 1 5 1 1 1 1 1 5 1
1 5 1 1 1 5 1 5 1 1 1 5 1 5 1 5 5 5 1 5 5 5 5 5 1 5 5 5 1 1 1 1 1 5 1 1 1 1 1 5 1
1 5 1 1 1 5 1 5 1 1 1 5 1 5 1 5 1 1 1 1 1 1 1 5 1 5 1 1 1 1 1 1 1 5 1 1 1 1 1 5 1
1 5 5 5 1 5 1 5 1 5 5 5 1 5 1 5 1 1 1 1 1 1 1 5 5 5 1 1 1 1 1 1 1 5 5 5 5 5 1 5 1
1 1 1 5 1 5 1 5 1 5 1 1 1 5 1 5 1 1 1 1 1 1 1 1 1 1 1 1 1 1 1 1 1 1 1 1 1 5 1 5 1
1 1 1 5 5 5 1 5 1 5 5 5 1 5 1 5 5 5 5 5 1 1 1 5 5 5 1 1 1 1 1 5 5 5 5 5 1 5 1 5 1
1 1 1 1 1 1 1 5 1 1 1 5 1 5 1 1 1 1 1 5 1 1 1 5 1 5 1 1 1 1 1 5 1 1 1 5 1 5 1 5 1
1 1 1 1 1 1 1 5 1 1 1 5 1 5 1 1 1 1 1 5 5 5 1 5 1 5 5 5 1 1 1 5 1 1 1 5 1 5 5 5 1
1 1 1 1 1 1 1 5 1 1 1 5 1 5 1 1 1 1 1 1 1 5 1 5 1 1 1 5 1 1 1 5 1 1 1 5 1 1 1 5 1
1 1 1 1 1 1 1 5 1 1 1 5 1 5 1 1 1 1 1 1 1 5 1 5 1 1 1 5 1 1 1 5 5 5 1 5 5 5 1 5 1
1 1 1 1 1 1 1 5 1 1 1 5 1 5 1 1 1 1 1 1 1 5 1 5 1 1 1 5 1 1 1 1 1 5 1 1 1 5 1 5 1
1 1 1 5 5 5 5 5 1 1 1 5 1 5 5 5 5 5 5 5 1 5 1 5 5 5 1 5 1 5 5 5 1 5 1 1 1 5 5 5 1
1 1 1 5 1 1 1 1 1 1 1 5 1 1 1 1 1 1 1 5 1 5 1 1 1 5 1 5 1 5 1 5 1 5 1 1 1 1 1 1 1
1 5 5 5 1 5 5 5 5 5 1 5 5 5 1 5 5 5 5 5 1 5 5 5 5 5 1 5 5 5 1 5 1 5 5 5 1 1 1 1 1
1 5 1 1 1 5 1 1 1 5 1 1 1 5 1 5 1 1 1 1 1 1 1 1 1 1 1 1 1 1 1 5 1 1 1 5 1 1 1 1 1
1 5 1 1 1 5 5 5 1 5 1 1 1 5 1 5 5 5 1 5 5 5 1 5 5 5 5 5 5 5 1 5 1 1 1 5 1 1 1 1 1
1 5 1 1 1 1 1 5 1 5 1 1 1 5 1 1 1 5 1 5 1 5 1 5 1 1 1 1 1 5 1 5 1 1 1 5 1 1 1 1 1
1 5 5 5 5 5 1 5 1 5 5 5 5 5 1 1 1 5 5 5 1 5 1 5 5 5 1 1 1 5 1 5 1 1 1 5 1 1 1 1 1
1 1 1 1 1 5 1 5 1 1 1 1 1 1 1 1 1 1 1 1 1 5 1 1 1 5 1 1 1 5 1 5 1 1 1 5 1 1 1 1 1
1 1 1 1 1 5 5 5 1 1 1 1 1 1 1 1 1 1 1 1 1 5 5 5 5 5 1 1 1 5 5 5 1 1 1 5 5 5 5 5 1
1 1 1 1 1 1 1 1 1 1 1 1 1 1 1 1 1 1 1 1 1 1 1 1 1 1 1 1 1 1 1 1 1 1 1 1 1 1 1 4 1
---
length=554
time=648
